EEEMRMMMX
EMEMEEMFE
MEEEMEMEE
EPEEFEMEE
EEECCCEME