EEEEEEEEEE
EEEEEEEEEE
EEEEEEEEEE
EEFEEEEPEE
EEEEEEPEEE
EFEEEEEEEE
EEEEEEPPEE
EEFEEEPEEE
EEEEEEEEEM