EEEMRMMMX
EMEMEEMEE
MEEEMEMEE
EPEEMEMEE
EEEMMMEME