EEEMRMMMX
EEEMEEMEE
MMEEMEMEE
EPEEMEMEE
EEEMMMEME