EEEPRPPPX
EEEPEEPEE
PPEEPEPEE
EMEEPEPEE
EEEPPPEPE